1111111111111111111111111
1C0000000011000CCCCCCC0E1
1011111111110111111111101
10000CCCCCCCCCCCCCCCCC001
1111011111011110111101111
1111011111011110111101111
1000000000000CCCCCC000001
1011111110111110111111101
1P00000000000000000000001
1011111111110111111111101
1111111111111111111111111
