11111111111111111111111111111111111111111111111111111
10000000000000000000000000000000000000000000000000001
10000000000000000000000000000000000000000000000000001
10000000000000000000000000000000000000000000000000001
10000000000000000001111111100000000000000000000000001
10000000000111111100000000000000000000000000000000001
10000000000000000011111100000000000000000000000000001
10000000000000000000000001111110000000000000000000001
10000000000000000000000000000000000000000000000000001
10000000000000000000000111111111111111111111111000001
10000000000000111111110000000000000000000000000000001
10000000111111000000000000000000000000000000000000001
10001111000000000000000000000000000000000000000000001
11111111111111111111111111111111111111111111111111111