1111111111111111111111111
1000000000110000000000001
1011111111110111111111101
1000000000000000000000001
1111011111011110111101111
1111011111011110111101111
1000000000000000000000001
1011111110111110111111101
1000000000000000000000001
1011111111110111111111101
1111111111111111111111111