1111111111111111111111111
1000000000000000000000001
1011111111111111111111101
1000000000000000000000001
1011111011110111101111101
1000000011110111100000001
1111111111011110111111111
1000000000000000000000001
1011111111110111111111101
1000000000000000000000001
1111111111111111111111111